{
  "maze": [
    ["#","#","#","#","#","#","#","#","#","#","#","#","#","#","#"],
    ["#","S"," "," ","#"," "," "," ","#"," ","#"," "," ","L","#"],
    ["#"," ","#","#","#"," ","#","#","#"," ","#","#","#"," ","#"],
    ["#"," "," "," ","#"," ","#"," ","#"," "," "," "," "," ","#"],
    ["#","#","#"," ","#"," ","#"," ","#","#","#"," ","#","#","#"],
    ["#"," ","B"," "," "," "," ","T"," "," "," "," "," "," ","#"],
    ["#","#","#","T","#","#","#","#","#","#","#"," ","#","#","#"],
    ["#"," "," ","T","#"," ","#"," "," "," "," "," ","#"," ","#"],
    ["#","#","#"," ","#"," ","#"," ","#","#","#"," ","#"," ","#"],
    ["#"," "," "," ","#"," "," "," ","#"," ","G"," ","#"," ","#"],
    ["#","#","#"," ","#","#","#"," ","#"," ","#"," ","#"," ","#"],
    ["#"," ","#","G","#"," ","G"," ","#"," ","#"," ","G"," ","#"],
    ["#"," ","#"," ","#","#","#"," ","#","#","#","#","#","#","#"],
    ["#"," ","G"," ","#"," "," "," "," ","G","G"," ","L","E","#"],
    ["#","#","#","#","#","#","#","#","#","#","#","#","#","#","#"]
  ]
}
