{
  "maze": [
    ["#","#","#","#","#","#","#","#","#","#","#","#","#","#","#"],
    ["#","S"," "," "," "," ","#"," ","L","G","#"," ","#"," ","#"],
    ["#","#","#"," ","#","#","#"," ","#"," ","#"," ","#"," ","#"],
    ["#"," ","#"," "," "," ","#"," ","#"," "," "," "," "," ","#"],
    ["#"," ","#"," ","#","#","#","G","#","#","#"," ","#","#","#"],
    ["#"," "," "," "," "," ","#"," ","#"," ","#"," "," "," ","#"],
    ["#"," ","#"," ","#"," ","#","G","#"," ","#"," ","#"," ","#"],
    ["#"," ","#"," ","#","B"," "," ","#","T"," "," ","#","G","#"],
    ["#"," ","#","#","#","#","#","#","#"," ","#","#","#","#","#"],
    ["#","G","G"," "," ","G","#"," "," "," "," "," ","T"," ","#"],
    ["#","#","#","#","#"," ","#","#","#","#","#","#","#","#","#"],
    ["#"," "," "," "," "," "," "," "," "," ","#","L","#"," ","#"],
    ["#","#","#"," ","#"," ","#","#","#","T","#"," ","#"," ","#"],
    ["#"," "," "," ","#"," ","#"," "," "," "," "," "," ","E","#"],
    ["#","#","#","#","#","#","#","#","#","#","#","#","#","#","#"]
  ]
}
