{
  "maze": [
    [ "#", "#", "#", "#", "#", "E", "#", "#", "#", "#", "#", "#", "#", "#", "#" ],
    [ "#", " ", " ", " ", " ", " ", "#", " ", "#", "L", " ", " ", " ", " ", "#" ],
    [ "#", " ", "#", "#", "#", " ", "#", "G", "#", "B", "#", " ", "#", " ", "#" ],
    [ "#", " ", "#", " ", " ", " ", " ", " ", " ", " ", "#", " ", "#", " ", "S" ],
    [ "#", "#", "#", "#", "#", " ", "#", "#", "#", "#", "#", "G", "#", " ", "#" ],
    [ "#", " ", " ", " ", " ", " ", "#", " ", " ", " ", " ", " ", "#", " ", "#" ],
    [ "#", "#", "#", "#", "#", "#", "#", "#", "#", " ", "#", "#", "#", "#", "#" ],
    [ "#", "G", " ", " ", " ", " ", "#", " ", " ", " ", " ", " ", "G", " ", "#" ],
    [ "#", "#", "#", " ", "#", "#", "#", "#", "#", "#", "#", "#", "#", " ", "#" ],
    [ "#", " ", " ", " ", "#", " ", " ", " ", " ", " ", " ", " ", "#", " ", "#" ],
    [ "#", "#", "#", " ", "#", " ", "#", " ", "#", " ", "#", " ", "#", " ", "#" ],
    [ "#", " ", " ", " ", " ", " ", "#", " ", "#", " ", "#", " ", " ", " ", "#" ],
    [ "#", "#", "#", "#", "#", " ", "#", " ", "#", "#", "#", " ", "#", "#", "#" ],
    [ "#", "G", " ", "T", " ", " ", "#", "T", "#", " ", "T", " ", " ", " ", "#" ],
    [ "#", "#", "#", "#", "#", "#", "#", "#", "#", "#", "#", "#", "#", "#", "#" ]
  ]
}
