{
  "maze": [
    ["#","#","#","#","#","#","#","#","#","#","#","#","#","#","#"],
    ["#","S","#"," ","#"," ","#"," "," "," "," "," "," "," ","#"],
    ["#","G","#"," ","#"," ","#","#","#","#","#","#","#","L","#"],
    ["#","G"," "," "," ","L","#"," "," "," "," "," "," "," ","#"],
    ["#","#","#","#","#"," ","#","#","#","#","#"," ","#","#","#"],
    ["#"," ","#"," "," ","T"," "," "," "," ","#"," "," "," ","#"],
    ["#"," ","#","#","#"," ","#","#","#","G","#","#","#","B","#"],
    ["#"," "," "," "," "," ","#"," "," "," "," "," ","#"," ","#"],
    ["#"," ","#","#","#","#","#"," ","#","#","#"," ","#"," ","#"],
    ["#"," ","#","G","T"," ","#"," "," "," ","#"," "," "," ","#"],
    ["#"," ","#","G","#"," ","#","#","#","#","#","#","#"," ","#"],
    ["#"," "," "," ","#"," ","#"," "," "," "," "," "," "," ","#"],
    ["#"," ","#"," ","#","#","#","G","#","#","#","#","#","#","#"],
    ["#"," ","#"," "," "," ","#","T"," "," "," "," ","G","E","#"],
    ["#","#","#","#","#","#","#","#","#","#","#","#","#","#","#"]
  ]
}
