{
  "maze": [
    ["#","#","#","#","#","#","#","#","#","#","#","#","#","#","#"],
    ["#"," "," "," ","#"," ","#","T"," "," "," "," "," "," ","#"],
    ["#","#","#"," ","#"," ","#","#","#","#","#","L","#"," ","#"],
    ["#"," ","#"," ","#"," ","#"," ","#"," "," "," ","#"," ","#"],
    ["#"," ","#"," ","#"," ","#"," ","#","B","#","#","#","L","#"],
    ["#"," "," "," ","#"," "," "," "," ","E"," "," ","#","G","#"],
    ["#","#","#"," ","#","#","#"," ","#","#","#","#","#","#","#"],
    ["#"," "," "," ","#"," ","#"," "," "," "," "," "," "," ","#"],
    ["#","#","#"," ","#","G","#","#","#"," ","#"," ","#"," ","#"],
    ["#"," "," "," ","#"," "," "," "," "," ","#"," ","#"," ","#"],
    ["#","#","#","T","#"," ","#","#","#","#","#"," ","#"," ","#"],
    ["#"," "," "," "," "," ","#","S"," "," "," ","T","#"," ","#"],
    ["#","#","#"," ","#","#","#","#","#","#","#","#","#","#","#"],
    ["#"," "," "," ","G"," "," "," "," "," "," "," "," "," ","#"],
    ["#","#","#","#","#","#","#","#","#","#","#","#","#","#","#"]
  ]
}
