{
  "maze": [
    ["#","#","#","#","#","#","#","#","#","#","#","#","#"],
    ["#"," "," "," "," "," ","*","E"," "," "," "," ","#"],
    ["#","#","#","#","#","#","*","#","#","#","#","#","#"],
    ["#","*","*","*","*","S","*","*","*"," "," "," ","#"],
    ["#","*","*","#","*","*","*","*","*"," ","T"," ","#"],
    ["#","g","*","#","#","#","#","#","*","#","#","#","#"],
    ["#"," ","*","#"," ","T"," "," ","*","*","*","g","#"],
    ["#","#","*","#","#","#","#","#","#","#","#","#","#"],
    ["#","g","*"," "," "," "," "," "," "," "," "," ","#"],
    ["#"," "," "," "," "," "," "," "," "," ","L","L","#"],
    ["#","#","#","#","#","#","#"," ","#","#","#","#","#"],
    ["#"," "," "," ","B"," "," "," "," "," "," "," ","#"],
    ["#","#","#","#","#","#","#","#","#","#","#","#","#"]
  ]
}
