{
  "maze": [
    ["#","#","#","#","#","#","#","#"],
    ["#","S"," "," ","#"," ","L","#"],
    ["#","#","#"," ","#","G","G","#"],
    ["#"," "," ","B"," "," "," ","#"],
    ["#"," ","#","#","#","#","#","#"],
    ["#"," "," ","E"," "," "," ","#"],
    ["#"," "," "," ","T"," "," ","#"],
    ["#","#","#","#","#","#","#","#"]
  ]
}
