{
  "maze": [
    ["#","#","#","#","#","#","#","#","#","#","#","#","#","#","#"],
    ["#","E"," "," ","#"," "," "," ","#"," "," "," ","#"," ","#"],
    ["#","#","#"," ","#"," ","#"," ","#","#","#"," ","#"," ","#"],
    ["#"," "," ","L","#"," ","#"," "," "," "," "," ","G"," ","#"],
    ["#"," ","#","#","#","#","#"," ","#"," ","#"," ","#"," ","#"],
    ["#"," ","#"," "," "," "," "," ","#"," ","#"," ","#"," ","#"],
    ["#"," ","#"," ","#","#","#"," ","#","#","#","#","#"," ","#"],
    ["#"," "," "," ","#"," "," ","G","#"," "," "," ","T"," ","#"],
    ["#","#","#","#","#","#","#"," ","#","#","#","#","#","#","#"],
    ["#"," ","#"," "," "," ","#"," ","#","S","#","G","#"," ","#"],
    ["#"," ","#"," ","#"," ","#"," ","#"," ","#"," ","#"," ","#"],
    ["#","L"," "," ","#","B","T"," "," "," ","#"," ","#"," ","#"],
    ["#","#","#"," ","#","#","#"," ","#","#","#"," ","#"," ","#"],
    ["#"," "," "," ","#","T"," "," "," "," "," "," "," "," ","#"],
    ["#","#","#","#","#","#","#","#","#","#","#","#","#","#","#"]
  ]
}
