{
  "maze": [
    ["#","#","#","#","#","#","#","#","#"],
    ["#","S"," "," "," ","G"," "," ","#"],
    ["#","#","#","#","#"," ","#","#","#"],
    ["#"," "," "," "," "," "," "," ","#"],
    ["#","B","#"," ","#"," ","#"," ","#"],
    ["#"," ","#"," ","#","L","#","T","#"],
    ["#"," ","#","#","#","#","#"," ","#"],
    ["#"," "," ","G","#"," "," ","E","#"],
    ["#","#","#","#","#","#","#","#","#"]
  ]
}
