{
  "maze": [
    ["#","#","#","#","#","#","#","#","#","#","#","#","#","#","#"],
    ["#","S"," "," "," "," ","#"," ","L"," ","#"," ","G"," ","#"],
    ["#"," ","#"," ","#"," ","#","#","#"," ","#"," ","#","#","#"],
    ["#"," ","#"," ","#","L","#"," "," "," ","#"," "," "," ","#"],
    ["#","#","#","#","#"," ","#","#","#"," ","#","#","#"," ","#"],
    ["#"," ","T"," ","#"," ","#"," "," "," ","#"," "," "," ","#"],
    ["#","#","#","B","#"," ","#","#","#"," ","#","#","#"," ","#"],
    ["#","T"," "," "," "," "," "," ","#"," ","#"," "," "," ","#"],
    ["#"," ","#","#","#"," ","#"," ","#"," ","#"," ","#","#","#"],
    ["#"," ","G"," ","#"," ","#"," "," "," ","#"," "," "," ","#"],
    ["#","#","#","#","#","#","#","#","#"," ","#","#","#"," ","#"],
    ["#","T"," "," "," ","G"," "," "," "," "," "," "," "," ","#"],
    ["#"," ","#","#","#","#","#","#","#","#","#","#","E","#","#"],
    ["#"," "," "," "," "," "," "," "," "," "," "," "," "," ","#"],
    ["#","#","#","#","#","#","#","#","#","#","#","#","#","#","#"]
  ]
}
