{
  "maze": [
    ["#","#","#","#","#","#","#","#","#","#","#","#","#","#","#"],
    ["#"," ","L"," "," ","#"," "," ","#"," "," "," "," "," ","#"],
    ["#","#","#"," ","#","#"," "," ","#"," ","#","#","#","#","#"],
    ["#"," "," "," "," ","#"," "," ","#"," ","#"," ","#"," ","#"],
    ["#"," "," "," ","E","#"," "," ","#"," "," "," ","#"," ","#"],
    ["#","#","#","#"," ","#"," "," "," "," ","#"," ","#"," ","#"],
    ["#"," "," "," "," ","#"," ","T","#"," ","#"," ","#"," ","#"],
    ["#"," "," "," "," "," ","L"," ","#"," ","#","G","#"," ","#"],
    ["#","#"," ","#","#","#","T","G","#"," ","#"," ","#"," ","#"],
    ["#"," "," "," "," ","#"," "," ","#"," ","#"," ","#"," ","#"],
    ["#","#","S","#","#","#"," "," ","#"," ","#"," "," "," ","#"],
    ["#"," "," "," ","T","#"," "," ","#"," ","#"," ","#"," ","#"],
    ["#","#","#","#"," ","#","#","#","#","#","#","#","#","#","#"],
    ["#"," "," ","B"," "," "," "," "," "," "," "," ","G"," ","#"],
    ["#","#","#","#","#","#","#","#","#","#","#","#","#","#","#"]
  ]
}
