{
  "maze": [
    ["#","#","#","#","#","#","#","#","#","#","#","#","#","#","#"],
    ["#","S"," "," "," "," "," "," "," "," ","#","G"," "," ","#"],
    ["#"," ","#","#","#","#","#","#","#","#","#"," ","#","#","#"],
    ["#"," "," "," "," "," ","#","L","#"," ","#","L"," ","G","#"],
    ["#"," ","#","#","#"," ","#"," ","#"," ","#","#","#"," ","#"],
    ["#"," ","#"," ","#"," ","G"," "," ","T","#"," "," "," ","#"],
    ["#"," ","#"," ","#"," ","#","#","#","#","#"," ","#","#","#"],
    ["#"," "," "," ","#"," "," "," "," ","G"," "," "," "," ","#"],
    ["#","#","#","#","#","#","#"," ","#","#","#","#","#"," ","#"],
    ["#"," ","#","G","T"," ","#"," ","#"," ","#"," ","T"," ","#"],
    ["#"," ","#"," ","#"," ","#"," ","#"," ","#","G","#","#","#"],
    ["#"," ","#"," ","#"," "," "," ","#"," ","#"," ","#"," ","#"],
    ["#"," ","#","#","#","B","#","#","#"," ","#"," ","#"," ","#"],
    ["#"," "," "," "," "," "," "," "," ","G","#"," "," ","E","#"],
    ["#","#","#","#","#","#","#","#","#","#","#","#","#","#","#"]
  ]
}
