{
  "maze": [
    ["#","#","#","#","#","#","#","#","#","#","#","#","#","#","#"],
    ["#","S"," ","G","#"," "," "," ","G"," "," "," ","#","T","#"],
    ["#","#","#"," ","#","#","#"," ","#"," ","#"," ","#"," ","#"],
    ["#","G"," "," ","#"," "," ","G","#"," ","#"," "," ","G","#"],
    ["#","#","#"," ","#","T","#","#","#","#","#"," ","#","#","#"],
    ["#"," "," ","L","#"," ","B"," ","#"," "," "," "," "," ","#"],
    ["#","#","#"," ","#"," ","#"," ","#","#","#"," ","#"," ","#"],
    ["#"," "," "," ","#"," ","#"," ","#"," "," "," ","#"," ","#"],
    ["#","#","#","G","#","#","#"," ","#","#","#","#","#","#","#"],
    ["#"," "," "," "," "," "," "," ","#"," "," "," ","#"," ","#"],
    ["#","#","#"," ","#"," ","#","#","#"," ","#"," ","#"," ","#"],
    ["#"," "," "," ","#"," "," "," "," "," ","#"," "," "," ","#"],
    ["#","#","#"," ","#","#","#","#","#","#","#"," ","#","#","#"],
    ["#","L","T"," ","#","G"," "," "," "," "," "," "," ","E","#"],
    ["#","#","#","#","#","#","#","#","#","#","#","#","#","#","#"]
  ]
}
