{
  "maze": [
    ["#","#","#","#","#","#","#","#","#"],
    ["#"," "," "," "," "," ","#","G","#"],
    ["#","#","#","#","S"," ","#"," ","#"],
    ["#"," ","#"," ","#","T","B"," ","#"],
    ["#","G","#"," ","#"," ","#"," ","#"],
    ["#"," "," "," "," ","L","#"," ","#"],
    ["#","#","#"," ","#","#","E"," ","#"],
    ["#"," "," "," "," "," ","#"," ","#"],
    ["#","#","#","#","#","#","#","#","#"]
  ]
}
