{
  "maze": [
    ["#","#","#","#","#","E","#","#","#","#","#","#","#","#","#"],
    ["#"," "," "," "," ","*","#"," ","#","L","*","*","*","*","#"],
    ["#"," ","#","#","#","*","#","g","#","B","#","*","#","*","#"],
    ["#"," ","#"," "," ","*","*","*","*","*","#","*","#","*","S"],
    ["#","#","#","#","#"," ","#","#","#","#","#","g","#"," ","#"],
    ["#"," "," "," "," "," ","#"," "," ","*","*","*","#"," ","#"],
    ["#","#","#","#","#","#","#","#","#","*","#","#","#","#","#"],
    ["#","g","*","*"," "," ","#"," "," ","*","*","*","g","*","#"],
    ["#","#","#","*","#","#","#","#","#","#","#","#","#","*","#"],
    ["#"," "," ","*","#","*","*","*","*","*","*","*","#","*","#"],
    ["#","#","#","*","#","*","#"," ","#"," ","#","*","#","*","#"],
    ["#"," "," ","*","*","*","#"," ","#"," ","#","*","*","*","#"],
    ["#","#","#","#","#","*","#"," ","#","#","#"," ","#","#","#"],
    ["#","g","*","t","*","*","#","T","#"," ","T"," "," "," ","#"],
    ["#","#","#","#","#","#","#","#","#","#","#","#","#","#","#"]
  ]
}
